WE assets/west.png
SO assets/south.png
EA assets/east.png
NO assets/north.png

F 146, 109, 39
C 135, 206, 235

    111111111
     100S001
      10001
       101
       111