NO assets/north.png
SO assets/south.png
WE assets/west.png
EA assets/east.png

F 146, 109, 39


1111111
100S001
1111111







